;
; $Id: 2C_HANGUL.KEY,v 1.1 1991/09/09 22:43:43 ohm Exp $
;
;; Hangul    Feb 7 1991

r	(!)	¤¡
s	(!)	¤¤
e	(!)	¤§
f	(!)	¤©
a	(!)	¤±
q	(!)	¤²
t	(!)	¤µ
d	(!)	¤·
w	(!)	¤¸
c       (!)	¤º
z	(!)	¤»
x	(!)	¤¼
v	(!)	¤½
g	(!)	¤¾

R       (!)     ¤¢
E       (!)     ¤¨
Q       (!)     ¤³
T	(!)	¤¶
W       (!)     ¤¹

k	(!)	¤¿
i	(!)	¤Á
j	(!)	¤Ã
u	(!)	¤Å
h	(!)	¤Ç
y	(!)	¤Ë
n	(!)	¤Ì
b	(!)	¤Ð
m	(!)	¤Ñ
l	(!)	¤Ó
o	(!)	¤À
p	(!)	¤Ä


;; 16.1 r ¤¡
¤¡k	(!)	°¡
°¡r	°¢
°¡s	°£
°¡e	°¤
°¡f	(!)	°¥
°¥r	°¦
°¥a	°§
°¡a	°¨
°¡q	(!)	°©
°©t	°ª
°¡t	°«
°¡T	°¬
°¡d  	°­
°¡w	°®
°¡c	°¯
°¡x	°°
°¡v	°±
°¡g	°²

¤¡o	(!)	°³
°³r	°´
°³s	°µ
°³f	°¶
°³a	°·
°³q	°¸
°³t	°¹
°³T	°º
°³d	°»

¤¡i	(!)	°¼
°¼r	°½
°¼s	°¾
°¼f	°¿
°¼t	°À
°¼d	°Á
°¼l	(!)	°Â
°Âs	°Ã
°Âf	°Ä

¤¡j	(!)	°Å
°År	°Æ
°Ås	°Ç
°Åe	°È
°Åf	(!)	°É
°Éa	°Ê
°Åa	°Ë
°Åq	°Ì
°Åt	°Í
°ÅT	°Î
°Åd	°Ï
°Åw	°Ð
°Åx	°Ñ
°Åv	°Ò
°Åg	°Ó

¤¡p	(!)	°Ô
°Ôs	°Õ
°Ôf	°Ö
°Ôa	°×
°Ôq	°Ø
°Ôt	°Ù
°ÔT	°Ú
°Ôd	°Û

¤¡u	(!)	°Ü
°Ür	°Ý
°ÜR	°Þ
°Üs	°ß
°Üe	°à
°Üf	°á
°Üa	°â
°Üq	°ã
°Üt	°ä
°ÜT	°å
°Üd	°æ
°Üx	°ç
°Ül	(!)	°è
°ès	°é
°èf	°ê
°èq	°ë
°èt	°ì

¤¡h	(!)	°í
°ír	°î
°ís	°ï
°íe	°ð
°íf	(!)	°ñ
°ña	°ò
°ñt	°ó
°ñg	°ô
°ía	°õ
°íq	°ö
°ít	°÷
°íd	°ø
°íw	°ù
°ík	(!)	°ú
°úr	°û
°ús	°ü
°úf	(!)	°ý
°ýa	°þ
°úa	±¡
°úq	±¢
°út	±£
°úd	±¤
°ío	(!)	±¥
±¥s	±¦
±¥f	±§
±¥q	±¨
±¥T	±©
±¥d	±ª
°íl	(!)	±«
±«r	±¬
±«s	±­
±«f	±®
±«a	±¯
±«q	±°
±«t	±±
±«d	±²

¤¡y	(!)	±³
±³s	±´
±³f	±µ
±³q	±¶
±³t	±·

¤¡n	(!)	±¸
±¸r	±¹
±¸s	±º
±¸e	±»
±¸f	(!)	±¼
±¼r	±½
±¼a	±¾
±¼g	±¿
±¸a	±À
±¸q	±Á
±¸t	±Â
±¸d	±Ã
±¸w	±Ä
±¸j	(!)	±Å
±År	±Æ
±Ås	±Ç
±Åf	±È
±ÅT	±É
±Åd     ±Ê
±¸p	(!)	±Ë
±Ët	±Ì
±¸l     (!)	±Í
±Ír	±Î
±Ís	±Ï
±Íf	±Ð
±Ía	±Ñ
±Íq	±Ò
±Ít	±Ó

¤¡b	(!)	±Ô
±Ôs	±Õ
±Ôf	±Ö

¤¡m	(!)	±×
±×r	±Ø
±×s	±Ù
±×e	±Ú
±×f	(!)	±Û
±Ûr	±Ü
±×a	±Ý
±×q	±Þ
±×t	±ß
±×d	±à
±×l	±á

¤¡l	(!)	±â
±âr	±ã
±âs	±ä
±âe	±å
±âf	(!)	±æ
±æa	±ç
±âa     ±è
±âq     ±é
±ât	±ê
±âd	±ë
±âw	±ì
±âv	±í


;; 17.78 R ¤¢
¤¢k	(!)	±î
±îr	(!)	±ï
±îR	±ð
±îs	±ñ
±îf	(!)	±ò
±òa	±ó
±îa	±ô
±îq	±õ
±ît	±ö
±îT	±÷
±îd	±ø
±îx	±ù

¤¢o	(!)	±ú
±úr	±û
±ús	±ü
±úf	±ý
±úa	±þ
±úq	²¡
±út	²¢
±úT	²£
±úd	²¤

¤¢i	(!)	²¥
²¥r     ²¦
²¥f	²§

¤¢j	(!)	²¨
²¨r	²©
²¨R	²ª
²¨s	²«
²¨f	²¬
²¨a	²­
²¨q	²®
²¨t	²¯
²¨T	²°
²¨d	²±
²¨l	(!)	²²
²²r	²³
²²s	²´
²²a	²µ
²²t	²¶
²²d	²·

¤¢u	(!)	²¸
²¸s	²¹
²¸f	²º
²¸t	²»
²¸T	²¼
²¸x	²½
²¸l	²¾

¤¢h	(!)	²¿
²¿r	²À
²¿s	(!)	²Á
²Ág	²Â
²¿f	²Ã
²¿a	²Ä
²¿q	²Å
²¿t	²Æ
²¿d	²Ç
²¿w	²È
²¿c	²É
²¿k	(!)	²Ê
²Êr	²Ë
²Êf	²Ì
²ÊT	²Í
²Êd     ²Î
²¿o	(!)	²Ï
²Ïr	²Ð
²Ïd	²Ñ
²¿l	(!)	²Ò
²Òs	²Ó
²Òf	²Ô
²Òa	²Õ
²Òq	²Ö
²Òd	²×

¤¢y	²Ø

¤¢n	(!)	²Ù
²Ùr	²Ú
²Ùs	²Û
²Ùf	(!)	²Ü
²Üg	²Ý
²Ùa	²Þ
²Ùq	²ß
²Ùt	²à
²Ùd	²á
²Ùw	²â
²Ùj	(!)	²ã
²ãf	²ä
²ãT	²å
²ãd	²æ
²Ùp	(!)	²ç
²çr	²è
²çs	²é
²çf	²ê
²ça	²ë
²çq	²ì
²çT	²í
²Ùl	(!)	²î
²îs	²ï
²îf	²ð
²îa	²ñ
²îq	²ò

¤¢b	²ó

¤¢m	(!)	²ô
²ôr	²õ
²ôs	(!)	²ö
²ög	²÷
²ôf	(!)	²ø
²øa	²ù
²øg	²ú
²ôa	²û
²ôq	²ü
²ôt	²ý
²ôd	²þ
²ôx	³¡

¤¢l	(!)	³¢
³¢r	³£
³¢s	³¤
³¢f	³¥
³¢a	³¦
³¢q	³§
³¢t	³¨
³¢d	³©


;; 19.10 s ¤¤
¤¤k	(!)	³ª
³ªr	³«
³ªR	³¬
³ªs	³­
³ªe	³®
³ªf	(!)	³¯
³¯r	³°
³¯a	³±
³ªa	³²
³ªq	³³
³ªt	³´
³ªT	³µ
³ªd	³¶
³ªw	³·
³ªc	³¸
³ªx	³¹
³ªg	³º

¤¤o	(!)	³»
³»r	³¼
³»s	³½
³»f	³¾
³»a	³¿
³»q	³À
³»t	³Á
³»T	³Â
³»d	³Ã

¤¤i	(!)	³Ä
³Är	³Å
³Äs	³Æ
³Äf	³Ç
³Äa	³È
³Äd	³É

¤¤j	(!)	³Ê
³Êr	(!)	³Ë
³Ët	³Ì
³Ês	³Í
³Êf	(!)	³Î
³Îa	³Ï
³Îq	³Ð
³Êa	³Ñ
³Êq	³Ò
³Êt	³Ó
³ÊT	³Ô
³Êd	³Õ
³Êg	³Ö

¤¤p	(!)	³×
³×r	³Ø
³×s	³Ù
³×f	³Ú
³×a	³Û
³×q	³Ü
³×t	³Ý
³×T	³Þ
³×d	³ß

¤¤u	(!)	³à
³àr	³á
³às	³â
³àf	³ã
³àa	³ä
³àq	³å
³àT	³æ
³àd     ³ç
³àz	³è
³àl	(!)	³é
³és	³ê

¤¤h	(!)	³ë
³ër	³ì
³ës	³í
³ëf	(!)	³î
³îa	³ï
³ëa	³ð
³ëq	³ñ
³ët	³ò
³ëd	³ó
³ëv	³ô
³ëg	³õ
³ëk	(!)	³ö
³ös	³÷
³öf	³ø
³öT	³ù
³ël	(!)	³ú
³ús	³û
³úf	³ü
³úa	³ý
³úq	³þ
³út	´¡

¤¤y	(!)	´¢
´¢r	´£
´¢s	´¤
´¢f	´¥
´¢q	´¦
´¢t	´§
´¢d	´¨

¤¤n	(!)	´©
´©r	´ª
´©s	´«
´©e	´¬
´©f	´­
´©a	´®
´©q	´¯
´©t	´°
´©d	´±
´©j	(!)	´²
´²T	´³
´©p     ´´
´©l	(!)	´µ
´µs	´¶
´µf	´·
´µa	´¸
´µq     ´¹

¤¤b	(!)	´º
´ºr	´»
´ºf	´¼
´ºa	´½
´ºq	´¾
´ºd	´¿

¤¤m	(!)	´À
´Àr	´Á
´Às	´Â
´Àf	(!)	´Ã
´Ãr	´Ä
´Ãa	´Å
´Àa	´Æ
´Àq	´Ç
´Àt	´È
´Àd	´É
´Àw	´Ê
´Àv	´Ë
´Àl	(!)	´Ì
´Ìs	´Í
´Ìf	´Î

¤¤l	(!)	´Ï
´Ïr	´Ð
´Ïs	´Ñ
´Ïf	(!)	´Ò
´Òa	´Ó
´Ïa	´Ô
´Ïq	´Õ
´Ït	´Ö
´Ïd	´×
´Ïv	´Ø


;; 20.57 e ¤§
¤§k	(!)	´Ù
´Ùr	´Ú
´ÙR	´Û
´Ùs	´Ü
´Ùe	´Ý
´Ùf	(!)	´Þ
´Þr	´ß
´Þa	´à
´Þq	´á
´Þg	´â
´Ùa	´ã
´Ùq	´ä
´Ùt	´å
´ÙT	´æ
´Ùd	´ç
´Ùw	´è
´Ùc	´é
´Ùg     ´ê

¤§o	(!)	´ë
´ër	´ì
´ës	´í
´ëf	´î
´ëa	´ï
´ëq	´ð
´ët	´ñ
´ëT	´ò
´ëd	´ó

¤§i	´ô

¤§j	(!)	´õ
´õr	´ö
´õR	´÷
´õs	´ø
´õe	´ù
´õf	(!)	´ú
´úa	´û
´úq	´ü
´õa	´ý
´õq	´þ
´õt	µ¡
´õd	µ¢
´õc	µ£
´õv	µ¤

¤§p	(!)	µ¥
µ¥r	µ¦
µ¥s	µ§
µ¥f	µ¨
µ¥a	µ©
µ¥q	µª
µ¥t	µ«
µ¥T	µ¬
µ¥d	µ­

¤§u	(!)	µ®
µ®s     µ¯
µ®f	µ°
µ®T	µ±
µ®d	µ²
µ®l	(!)	µ³
µ³s	µ´

¤§h	(!)	µµ
µµr	µ¶
µµs	µ·
µµe	µ¸
µµf	(!)	µ¹
µ¹a	µº
µ¹t	µ»
µµa	µ¼
µµq	µ½
µµt	µ¾
µµd	µ¿
µµc	µÀ
µµx	µÁ
µµk	(!)	µÂ
µÂs	µÃ
µÂf	µÄ
µµo	(!)	µÅ
µÅT	µÆ
µµl	(!)	µÇ
µÇs	µÈ
µÇf	µÉ
µÇa	µÊ
µÇq	µË
µÇt	µÌ

¤§y	µÍ

¤§n	(!)	µÎ
µÎr	µÏ
µÎs	µÐ
µÎf	µÑ
µÎa	µÒ
µÎq	µÓ
µÎt	µÔ
µÎd	µÕ
µÎj	(!)	µÖ
µÖT	µ×
µÎp	(!)	µØ
µØd	µÙ
µÎl	(!)	µÚ
µÚs	µÛ
µÚf	µÜ
µÚq	µÝ
µÚt	µÞ
µÚd	µß

¤§b	(!)	µà
µàs	µá
µàf	µâ
µàa	µã
µàd	µä

¤§m	(!)	µå
µår	µæ
µås	µç
µåe	µè
µåf	(!)	µé
µéa	µê
µåa	µë
µåq	µì
µåt	µí
µåd	µî
µål	µï

¤§l	(!)	µð
µðr	µñ
µðs	µò
µðe	µó
µðf	µô
µða	µõ
µðq	µö
µðt	µ÷
µðT	µø
µðd	µù
µðw	µú


;; 21.91 E ¤¨
¤¨k	(!)	µû
µûr	µü
µûs	µý
µûf	µþ
µûa	¶¡
µûq	¶¢
µût	¶£
µûT	¶¤
µûd	¶¥
µûg	¶¦

¤¨o	(!)	¶§
¶§r	¶¨
¶§s	¶©
¶§f	¶ª
¶§a	¶«
¶§q	¶¬
¶§t	¶­
¶§T	¶®
¶§d	¶¯

¤¨j	(!)	¶°
¶°r	¶±
¶°s     ¶²
¶°f	(!)	¶³
¶³a	¶´
¶³q	¶µ
¶°a	¶¶
¶°q	¶·
¶°t	¶¸
¶°T	¶¹
¶°d	¶º
¶°g	¶»

¤¨p	(!)	¶¼
¶¼r	¶½
¶¼s	¶¾
¶¼f	¶¿
¶¼a	¶À
¶¼q	¶Á
¶¼t	¶Â
¶¼T	¶Ã
¶¼d	¶Ä

¤¨u	(!)	¶Å
¶ÅT	¶Æ

¤¨h     (!)	¶Ç
¶Çr	¶È
¶Çs	¶É
¶Çf	¶Ê
¶Çd	¶Ë
¶Çk	(!)	¶Ì
¶Ìf	¶Í
¶Ço	¶Î
¶Çl	(!)	¶Ï
¶Ïs	¶Ð

¤¨n	(!)	¶Ñ
¶Ñr	¶Ò
¶Ñs	¶Ó
¶Ñf	(!)	¶Ô
¶Ôg	¶Õ
¶Ña	¶Ö
¶Ñd	¶×
¶Ñp	¶Ø
¶Ñl	(!)	¶Ù
¶Ùs	¶Ú
¶Ùf	¶Û
¶Ùa	¶Ü
¶Ùq	¶Ý
¶Ùd	¶Þ

¤¨m	(!)	¶ß
¶ßr	¶à
¶ßs	¶á
¶ße	¶â
¶ßf	¶ã
¶ßa	¶ä
¶ßq	¶å
¶ßt	¶æ
¶ßl	(!)	¶ç
¶çs	¶è
¶çf	¶é
¶ça	¶ê
¶çq	¶ë

¤¨l	(!)	¶ì
¶ìs	¶í
¶ìf	¶î
¶ìa	¶ï
¶ìq	¶ð
¶ìt	¶ñ
¶ìd	¶ò


;; 22.83 f ¤©
¤©k	(!)	¶ó
¶ór	¶ô
¶ós	¶õ
¶óf	¶ö
¶óa	¶÷
¶óq	¶ø
¶ót	¶ù
¶óT	¶ú
¶ód	¶û
¶ów	¶ü
¶óv	¶ý
¶óg	¶þ

¤©o	(!)	·¡
·¡r	·¢
·¡s	·£
·¡f	·¤
·¡a	·¥
·¡q	·¦
·¡t	·§
·¡T	·¨
·¡d	·©

¤©i	(!)	·ª
·ªr	·«
·ªs	·¬
·ªt	·­
·ªd	·®

¤©j	(!)	·¯
·¯r	·°
·¯s	·±
·¯f	·²
·¯a	·³
·¯q	·´
·¯t	·µ
·¯T	·¶
·¯d	··
·¯g	·¸

¤©p	(!)	·¹
·¹r	·º
·¹s	·»
·¹f	·¼
·¹a	·½
·¹q	·¾
·¹t	·¿
·¹d	·À
¤©u	(!)	·Á
·Ár	·Â
·Ás	·Ã
·Áf	·Ä
·Áa	·Å
·Áq	·Æ
·Át	·Ç
·ÁT	·È
·Ád	·É
·Ál	(!)	·Ê
·Ês	·Ë
·Êq	·Ì
·Êt	·Í

¤©h	(!)	·Î
·Îr	·Ï
·Îs	·Ð
·Îf	·Ñ
·Îa	·Ò
·Îq	·Ó
·Ît	·Ô
·Îd	·Õ
·Îk	(!)	·Ö
·Ös	·×
·Öd	·Ø
·ÎoT	·Ù
·Îl	(!)	·Ú
·Ús	·Û
·Úf	·Ü
·Úa	·Ý
·Úq	·Þ
·Út	·ß
·Úd	·à

¤©y	(!)	·á
·ás	·â
·áf	·ã
·áq	·ä
·át	·å
·ád	·æ

¤©n	(!)	·ç
·çr    	·è
·çs	·é
·çf	·ê
·ça	·ë
·çq	·ì
·çt	·í
·çd	·î
·çj	(!)	·ï
·ïT	·ð
·çp	·ñ
·çl	(!)	·ò
·òr	·ó
·òs	·ô
·òf	·õ
·òa	·ö
·òt	·÷
·òd	·ø

¤©b	(!)	·ù
·ùr	·ú
·ùs	·û
·ùf	·ü
·ùa	·ý
·ùq	·þ
·ùt	¸¡
·ùd	¸¢

¤©m	(!)	¸£
¸£r	¸¤
¸£s	¸¥
¸£f	¸¦
¸£a	¸§
¸£q	¸¨
¸£t	¸©
¸£d	¸ª
¸£w	¸«
¸£x	¸¬
¸£v	¸­

¤©l	(!)	¸®
¸®r	¸¯
¸®s	¸°
¸®f	¸±
¸®a	¸²
¸®q	¸³
¸®t	¸´
¸®d	¸µ


;; 24.22 a ¤±
¤±k	(!)	¸¶
¸¶r	¸·
¸¶a	(!)	¸¸
¸¸g	¸¹
¸¶e	¸º
¸¶f	(!)	¸»
¸»r	¸¼
¸»a	¸½
¸¶a	¸¾
¸¶q	¸¿
¸¶t	¸À
¸¶d	¸Á
¸¶w	¸Â
¸¶x	¸Ã
¸¶g	¸Ä

¤±o	(!)	¸Å
¸År	¸Æ
¸Ås	¸Ç
¸Åf	¸È
¸Åa	¸É
¸Åq	¸Ê
¸Åt	¸Ë
¸ÅT	¸Ì
¸Åd	¸Í
¸Åw	¸Î

¤±i	(!)	¸Ï
¸Ïr	¸Ð
¸Ïf	¸Ñ
¸Ïd	¸Ò

¤±j	(!)	¸Ó
¸Ór	¸Ô
¸Ós	¸Õ
¸Óf	(!)	¸Ö
¸Öa     ¸×
¸Óa	¸Ø
¸Óq	¸Ù
¸Ót	¸Ú
¸Ód	¸Û
¸Ów	¸Ü
¸Óg	¸Ý

¤±p	(!)	¸Þ
¸Þr	¸ß
¸Þs	¸à
¸Þf	¸á
¸Þa	¸â
¸Þq	¸ã
¸Þt	¸ä
¸ÞT	¸å
¸Þd	¸æ
¤±u	(!)	¸ç
¸çr	¸è
¸çs	¸é
¸çf	¸ê
¸çt	¸ë
¸çT	¸ì
¸çd	¸í
¸çc	¸î
¸çl	¸ï

¤±h	(!)	¸ð
¸ðr	(!)	¸ñ
¸ñt     ¸ò
¸ðs	¸ó
¸ðf	(!)	¸ô
¸ôa	¸õ
¸ða	¸ö
¸ðq	¸÷
¸ðt	¸ø
¸ðd	¸ù
¸ðk	(!)	¸ú
¸ús	¸û
¸úT	¸ü
¸úd     ¸ý
¸ðl	(!)	¸þ
¸þs	¹¡
¸þf	¹¢
¸þq	¹£
¸þt	¹¤
¸þd	¹¥

¤±y	(!)	¹¦
¹¦s	¹§
¹¦f	¹¨
¹¦q	¹©
¹¦t	¹ª

¤±n	(!)     ¹«
¹«r	¹¬
¹«R	¹­
¹«s	¹®
¹«e	¹¯
¹«f	(!)	¹°
¹°r	¹±
¹°a	¹²
¹«a	¹³
¹«q	¹´
¹«t	¹µ
¹«d	¹¶
¹«x	¹·
¹«g	¹¸
¹«j	(!)	¹¹
¹¹s	¹º
¹¹f	¹»
¹¹q	¹¼
¹¹t	¹½
¹«p	¹¾
¹«l	(!)	¹¿
¹¿s	¹À
¹¿f	¹Á

¤±b	(!)	¹Â
¹Âs	¹Ã
¹Âf	¹Ä
¹Âa	¹Å
¹Ât	¹Æ

¤±m	(!)	¹Ç
¹Çs	¹È
¹Çf	¹É
¹Ça	¹Ê
¹Çt	¹Ë

¤±l	(!)	¹Ì
¹Ìr	¹Í
¹Ìs	¹Î
¹Ìe	¹Ï
¹Ìf	(!)	¹Ð
¹Ða	¹Ñ
¹Ìa	¹Ò
¹Ìq	¹Ó
¹Ìt	¹Ô
¹ÔT	¹Õ
¹Ìd	¹Ö
¹Ìc	¹×
¹Ìx	¹Ø


;; 25.57 q ¤²
¤²k	(!)	¹Ù
¹Ùr	¹Ú
¹ÙR	¹Û
¹Út	¹Ü
¹Ùs	¹Ý
¹Ùe	¹Þ
¹Ùf	(!)	¹ß
¹ßr	¹à
¹ßa	¹á
¹ßq	¹â
¹Ùa	¹ã
¹Ùq	¹ä
¹Ùt	¹å
¹Ùd	¹æ
¹Ùx	¹ç

¤²o	(!)	¹è
¹èr	¹é
¹ès	¹ê
¹èf	¹ë
¹èa	¹ì
¹èq	¹í
¹èt	¹î
¹èT	¹ï
¹èd	¹ð
¹èx	¹ñ
¤²i	(!)	¹ò
¹òr	¹ó
¹òs	¹ô
¹òq	¹õ

¤²j	(!)	¹ö
¹ör	¹÷
¹ös	¹ø
¹öe     ¹ù
¹öf	(!)	¹ú
¹úa	¹û
¹öa	¹ü
¹öq	¹ý
¹öt	¹þ
¹öd	º¡
¹öw	º¢

¤²p	(!)	º£
º£r	º¤
º£s	º¥
º£e	º¦
º£f	º§
º£a	º¨
º£q	º©
º£t	ºª
º£T	º«
º£d     º¬

¤²u	(!)	º­
º­r	º®
º­s	º¯
º­f	º°
º­q	º±
º­t	º²
º­T	º³
º­d	º´
º­x	ºµ
º­l	(!)	º¶
º¶s	º·

¤²h	(!)	º¸
º¸r	º¹
º¸R	ºº
º¸s	º»
º¸f	º¼
º¸a	º½
º¸q	º¾
º¸t	º¿
º¸d	ºÀ
º¸k	(!)	ºÁ
ºÁs	ºÂ
ºÁT	ºÃ
º¸o	(!)	ºÄ
ºÄT	ºÅ
º¸l	(!)	ºÆ
ºÆr	ºÇ
ºÆs	ºÈ
ºÆf	ºÉ
ºÆa	ºÊ
ºÆq	ºË

¤²y	(!)	ºÌ
ºÌs	ºÍ

¤²n	(!)	ºÎ
ºÎr	ºÏ
ºÎs	ºÐ
ºÎe	ºÑ
ºÎf	(!)	ºÒ
ºÒr	ºÓ
ºÒa	ºÔ
ºÎa	ºÕ
ºÎq	ºÖ
ºÎt	º×
ºÎd	ºØ
ºÎx	ºÙ
ºÎv	ºÚ
ºÎj	(!)	ºÛ
ºÛf     ºÜ	
ºÛT	ºÝ
ºÎp     ºÞ
ºÎl	(!)	ºß
ºßr	ºà
ºßs	ºá
ºßf	ºâ
ºßd	ºã

¤²b	(!)	ºä
ºäs	ºå
ºäf	ºæ
ºäa	ºç
ºät	ºè
ºäd	ºé

¤²m	(!)	ºê
ºêr	ºë
ºês	ºì
ºêf	ºí
ºêa	ºî
ºêq	ºï
ºêt	ºð

¤²l     (!)	ºñ
ºñr	ºò
ºñs	ºó
ºñf	(!)	ºô
ºôa	ºõ
ºña	ºö
ºñq	º÷
ºñt	ºø
ºñd	ºù
ºñw	ºú
ºñc	ºû


;; 26.92 Q ¤³
¤³k	(!)	ºü
ºür	ºý
ºüs	ºþ
ºüf	(!)	»¡
»¡a	»¢
ºüa	»£
ºüq	»¤
ºüt	»¥
ºüT	»¦
ºüd	»§
ºüg	»¨

¤³o	(!)	»©
»©r	»ª
»©s	»«
»©f	»¬
»©a	»­
»©q	»®
»©t	»¯
»©T	»°
»©d	»±

¤³i	(!)	»²
»²r	»³
»²a	»´

¤³j	(!)	»µ
»µr	»¶
»µs	»·
»µe	»¸
»µf	»¹
»µa	»º
»µt	»»
»µT	»¼
»µd	»½

¤³p	(!)	»¾	
»¾d	»¿

¤³u	(!)	»À
»Àr	»Á
»Àa	»Â
»Àq	»Ã
»Àt	»Ä
»ÀT     »Å
»Àd	»Æ

¤³h	(!)	»Ç
»Çr	»È
»Çs	»É
»Çf	»Ê
»Ça	»Ë
»Çq	»Ì
»Çd	»Í
»Çl	»Î

¤³y	(!)	»Ï
»Ïd	»Ð

¤³n     (!)	»Ñ
»Ñr	»Ò
»Ñs	»Ó
»Ñf	»Ô
»Ña	»Õ
»Ñt	»Ö
»Ñd	»×

¤³b	(!)	»Ø
»Ød	»Ù

¤³m    (!)	»Ú
»Ús	»Û
»Úf	»Ü
»Úa	»Ý
»Úq	»Þ

¤³l	(!)	»ß
»ßr	»à
»ßs	»á
»ßf	»â
»ßa	»ã
»ßq	»ä
»ßt	»å
»ßd	»æ


;; 27.71 t ¤µ
¤µk	(!)	»ç
»çr	(!)	»è
»èt	»é
»çs	»ê
»çe	»ë
»çf	(!)	»ì
»ìr	»í
»ìa	»î
»ça	»ï
»çq	»ð
»çt	»ñ
»ñT	»ò
»çd	»ó
»çx	»ô

¤µo	(!)	»õ
»õr	»ö
»õs	»÷
»õf	»ø
»õa	»ù
»õq	»ú
»õt	»û
»õT	»ü
»õd	»ý

¤µi	(!)	»þ
»þr	¼¡
»þs	¼¢
»þf	¼£
»þa	¼¤
»þq	¼¥
»þt	¼¦
»þd	¼§
»þl	(!)	¼¨
¼¨s	¼©
¼¨f	¼ª
¼¨a	¼«
¼¨d	¼¬

¤µj	(!)	¼­
¼­r	¼®
¼­R	¼¯
¼®t	¼°
¼­s	¼±
¼­e	¼²
¼­f	(!)	¼³
¼³a	¼´
¼³q	¼µ
¼­a	¼¶
¼­q	¼·
¼­t	¼¸
¼­T	¼¹
¼­d	¼º
¼­v	¼»

¤µp	(!)	¼¼
¼¼r	¼½
¼¼s	¼¾
¼¼f	¼¿
¼¼a	¼À
¼¼q	¼Á
¼¼t	¼Â
¼¼T	¼Ã
¼¼d	¼Ä

¤µu	(!)	¼Å
¼År	¼Æ
¼Ås	¼Ç
¼Åf	¼È
¼Åa	¼É
¼Åq	¼Ê
¼Åt	¼Ë
¼ÅT	¼Ì
¼Åd	¼Í
¼Ål	(!)	¼Î
¼Îs	¼Ï
¼Îf	¼Ð
¼Îd	¼Ñ

¤µh	(!)	¼Ò
¼Òr	¼Ó
¼ÒR	¼Ô
¼Òs	¼Õ
¼Òf	(!)	¼Ö
¼Öa	¼×
¼Òa	¼Ø
¼Òq	¼Ù
¼Òt	¼Ú
¼Òd	¼Û
¼Òx	¼Ü
¼Òk	(!)	¼Ý
¼Ýr	¼Þ
¼Ýs	¼ß
¼Ýf	¼à
¼Ýd	¼á
¼Òo	(!)	¼â
¼âs	¼ã
¼âf	¼ä
¼âa	¼å
¼ât	¼æ
¼âT	¼ç
¼Òl	(!)	¼è
¼ès	¼é
¼èf	¼ê
¼èa	¼ë
¼èq	¼ì
¼èt	¼í

¤µy	(!)	¼î
¼îr	¼ï
¼îs	¼ð
¼îf	¼ñ
¼îa	¼ò
¼îq	¼ó
¼ît     ¼ô
¼îd	¼õ

¤µn	(!)	¼ö
¼ör	¼÷
¼ös	¼ø
¼öe	¼ù
¼öf	¼ú
¼öa	¼û
¼öq	¼ü
¼öt	¼ý
¼öd	¼þ
¼öc	½¡
¼öx	½¢
¼öv	½£
¼öj	(!)	½¤
½¤T	½¥
¼öp	(!)	½¦
½¦r	½§
½¦s	½¨
½¦f	½©
½¦a	½ª
½¦d	½«
¼öl	(!)	½¬
½¬r	½­
½¬s	½®
½¬f	½¯
½¬a	½°
½¬q	½±
½¬t	½²
½¬d	½³

¤µb	(!)	½´
½´r	½µ
½´f	½¶
½´a	½·
½´t	½¸
½´d	½¹

¤µm	(!)	½º
½ºr	½»
½ºs	½¼
½ºf	(!)	½½
½½r	½¾
½ºa	½¿
½ºq	½À
½ºt	½Á
½ºd	½Â

¤µl	(!)	½Ã
½Ãr	½Ä
½Ãs	½Å
½Ãe	½Æ
½Ãf	(!)	½Ç
½Çg	½È
½Ãa	½É
½Ãq	½Ê
½Ãt	½Ë
½Ãd	½Ì
½Ãv	½Í


;; 29.46 T ¤¶
¤¶k     (!)	½Î
½Îr	(!)	½Ï
½Ït	½Ð
½Îs	½Ñ
½Îf	½Ò
½Îa	½Ó
½Îq	½Ô
½ÎT	½Õ
½Îd     ½Ö
½Îg	½×

¤¶o	(!)	½Ø
½Ør	½Ù
½Øs	½Ú
½Øf	½Û
½Øa	½Ü
½Øq	½Ý
½ØT	½Þ
½Ød     ½ß

¤¶id    ½à

¤¶j	(!)	½á
½ár	½â
½ás	½ã
½áf	(!)	½ä
½äq	½å
½áa	½æ
½áq	½ç
½áT	½è
½ád     ½é

¤¶p	(!)	½ê
½ês	½ë
½êf	½ì

¤¶uls	½í

¤¶h	(!)	½î
½îr	½ï
½îs	½ð
½îe	½ñ
½îf	(!)	½ò
½òa	½ó
½îa	½ô
½îq	½õ
½îd	½ö
½îk	(!)	½÷
½÷r	½ø
½÷s	½ù
½÷T	½ú

½îo     (!)	½û
½ûT	½ü
½îl	(!)	½ý
½ýs	½þ
½ýf     ¾¡
½ýa	¾¢
½ýq	¾£

¤¶y	¾¤

¤¶n	(!)	¾¥
¾¥r	¾¦
¾¥s	¾§
¾¥f	¾¨
¾¥a	¾©
¾¥q	¾ª
¾¥d	¾«
¾¥j     (!)	¾¬
¾¬T	¾­
¾¬p	¾®
¾¥l	(!)	¾¯
¾¯s	¾°

¤¶bd	¾±

¤¶m	(!)	¾²
¾²r	¾³
¾²s	¾´
¾²f	(!)	¾µ
¾µa	¾¶
¾µg	¾·
¾²a	¾¸
¾²q	¾¹
¾²l	(!)	¾º
¾ºs	¾»
¾ºf	¾¼
¾ºa	¾½

¤¶l	(!)	¾¾
¾¾r	¾¿
¾¾s	¾À
¾¾f	¾Á
¾¾a	¾Â
¾¾q	¾Ã
¾¾t	¾Ä
¾¾d	¾Å


;; 30.38 d ¤·
¤·k	(!)	¾Æ
¾Ær	¾Ç
¾Æs	(!)	¾È
¾Èw	¾É
¾Èg	¾Ê
¾Æf	(!)	¾Ë
¾Ër	¾Ì
¾Ëa	¾Í
¾Ëg	¾Î
¾Æa	¾Ï
¾Æq	¾Ð
¾Æt	¾Ñ
¾ÆT	¾Ò
¾Æd	¾Ó
¾Æx	¾Ô
¾Æv	¾Õ

¤·o	(!)	¾Ö
¾Ör	¾×
¾Ös	¾Ø
¾Öf	¾Ù
¾Öa	¾Ú
¾Öq	¾Û
¾Öt	¾Ü
¾ÖT	¾Ý
¾Öd	¾Þ

¤·i	(!)	¾ß
¾ßr	¾à
¾ßs	¾á
¾ßf	(!)	¾â
¾âq	¾ã
¾ßa	¾ä
¾ßq	¾å
¾ßt	¾æ
¾ßd	¾ç
¾ßx	¾è
¾ßg	¾é
¾ßl	(!)	¾ê
¾ês	¾ë
¾êf	¾ì
¾êq	¾í

¤·j	(!)	¾î
¾îr	¾ï
¾îs	(!)	¾ð
¾ðw	¾ñ
¾îe	¾ò
¾îf	(!)	¾ó
¾ór	¾ô
¾óa	¾õ
¾îa     ¾ö
¾îq	(!)	¾÷
¾÷t	¾ø
¾ît	¾ù
¾îT	¾ú
¾îd	¾û
¾îw	¾ü
¾îz	¾ý
¾îv	¾þ

¤·p	(!)	¿¡
¿¡r	¿¢
¿¡s	¿£
¿¡f	¿¤
¿¡a	¿¥
¿¡q	¿¦
¿¡t	¿§
¿¡d	¿¨

¤·u	(!)	¿©
¿©r	¿ª
¿©R	¿«
¿©s	¿¬
¿©f	(!)	¿­
¿­a	¿®
¿­q	¿¯
¿©a	¿°
¿©q	(!)	¿±
¿±t	¿²
¿©t	¿³
¿©T	¿´
¿©d	¿µ
¿©x	¿¶
¿©v	¿·
¿©g	¿¸
¿©l	(!)	¿¹
¿¹s     ¿º
¿¹f	¿»
¿¹a	¿¼
¿¹q	¿½
¿¹t	¿¾
¿¹T	¿¿

¤·h	(!)	¿À
¿Àr	¿Á
¿Às	¿Â
¿Àf	(!)	¿Ã
¿Ãr	¿Ä
¿Ãa	¿Å
¿Ãt	¿Æ
¿Ãg	¿Ç
¿Àa	¿È
¿Àq     ¿É
¿Àt	¿Ê
¿Àd	¿Ë
¿Àc	¿Ì
¿Àk	(!)	¿Í
¿Ír	¿Î
¿Ís	¿Ï
¿Íf	¿Ð
¿Ía	¿Ñ
¿Íq	¿Ò
¿Ít	¿Ó
¿ÍT	¿Ô
¿Íd	¿Õ
¿Ào	(!)	¿Ö
¿Ör	¿×
¿Ös	¿Ø
¿Öa	¿Ù
¿Öt	¿Ú
¿Öd	¿Û
¿Àl	(!)	¿Ü
¿Ür	¿Ý
¿Üs	¿Þ
¿Üf	¿ß
¿Üa	¿à
¿Üq	¿á
¿Üt	¿â
¿Üd	¿ã

¤·y	(!)	¿ä
¿är	¿å
¿äs     ¿æ
¿äf	¿ç
¿äa	¿è
¿äq	¿é
¿ät	¿ê
¿äd	¿ë

¤·n	(!)	¿ì
¿ìr	¿í
¿ìs	¿î
¿ìf	(!)	¿ï
¿ïr	¿ð
¿ïa	¿ñ
¿ìa	¿ò
¿ìq	¿ó
¿ìt	¿ô
¿ìd	¿õ
¿ìj	(!)	¿ö
¿ör	¿÷
¿ös	¿ø
¿öf	¿ù
¿öa	¿ú
¿öq	¿û
¿öT	¿ü
¿öd     ¿ý
¿ìp	(!)	¿þ
¿þr	À¡
¿þs	À¢
¿þf	À£
¿þa	À¤
¿þq	À¥
¿þd	À¦
¿ìl	(!)	À§
À§r	À¨
À§s	À©
À§f	Àª
À§a	À«
À§q	À¬
À§t     À­
À§d	À®

¤·b	(!)	À¯
À¯r	À°
À¯s	À±
À¯f	À²
À¯a	À³
À¯q	À´
À¯t	Àµ
À¯d	À¶
À¯g	À·

¤·m	(!)	À¸
À¸r	À¹
À¸s	Àº
À¸f	(!)	À»
À»v	À¼
À¸a	À½
À¸q	À¾
À¸t	À¿
À¸d	ÀÀ
À¸w	ÀÁ
À¸c	ÀÂ
À¸z	ÀÃ
À¸x	ÀÄ
À¸v	ÀÅ
À¸g	ÀÆ
À¸l	(!)	ÀÇ
ÀÇs	ÀÈ
ÀÇf	ÀÉ
ÀÇa	ÀÊ
ÀÇt	ÀË

¤·l	(!)	ÀÌ
ÀÌr	ÀÍ
ÀÌs	ÀÎ
ÀÌf	(!)	ÀÏ
ÀÏr	ÀÐ
ÀÏa	ÀÑ
ÀÏg	ÀÒ
ÀÌa	ÀÓ
ÀÌq	ÀÔ
ÀÌt	ÀÕ
ÀÌT	ÀÖ
ÀÌd	À×
ÀÌw	ÀØ
ÀÌv	ÀÙ


;; 32.58 w ¤¸
¤¸k	(!)	ÀÚ
ÀÚr	ÀÛ
ÀÚs	(!)	ÀÜ
ÀÜg	ÀÝ
ÀÚe	ÀÞ
ÀÚf	(!)	Àß
Àßa     Àà
ÀÚa	Àá
ÀÚq	Àâ
ÀÚt	Àã
ÀÚT	Àä
ÀÚd	Àå
ÀÚw	Àæ

¤¸o	(!)	Àç
Àçr	Àè
Àçs	Àé
Àçf	Àê
Àça	Àë
Àçq	Àì
Àçt	Àí
ÀçT	Àî
Àçd	Àï

¤¸i	(!)	Àð
Àðr	Àñ
Àðs	(!)	Àò
Àòg	Àó
Àðf	Àô
Àða	Àõ
Àðd	Àö
Àðl	(!)	À÷
À÷s	Àø
À÷f	Àù

¤¸j	(!)	Àú
Àúr	Àû
Àús	Àü
Àúf	(!)	Àý
Àýa	Àþ
Àúa	Á¡
Àúq	Á¢
Àút     Á£
Àúd	Á¤
Àúw	Á¥

¤¸p	(!)	Á¦
Á¦r	Á§
Á¦s	Á¨
Á¦f	Á©
Á¦a	Áª
Á¦q	Á«
Á¦t	Á¬
Á¦d	Á­

¤¸u	(!)	Á®
Á®s	Á¯
Á®f	Á°
Á®a	Á±
Á®q	Á²
Á®T	Á³
Á®d     Á´
Á®l	Áµ

¤¸h	(!)	Á¶
Á¶r	Á·
Á¶s	Á¸
Á¶f	(!)	Á¹
Á¹a	Áº
Á¶a	Á»
Á¶q	Á¼
Á¶t	Á½
Á¶d	Á¾
Á¶w	Á¿
Á¶c	ÁÀ
Á¶g	ÁÁ
Á¶k	(!)	ÁÂ
ÁÂr	ÁÃ
ÁÂf	ÁÄ
ÁÂq	ÁÅ
ÁÂt	ÁÆ
ÁÂd	ÁÇ
Á¶o	(!)	ÁÈ
ÁÈT	ÁÉ
ÁÈd	ÁÊ
Á¶l	(!)	ÁË
ÁËs	ÁÌ
ÁËf	ÁÍ
ÁËa	ÁÎ
ÁËq	ÁÏ
ÁËt	ÁÐ
ÁËd	ÁÑ

¤¸y	(!)	ÁÒ
ÁÒr	ÁÓ
ÁÒs	ÁÔ
ÁÒd	ÁÕ

¤¸n	(!)	ÁÖ
ÁÖr	Á×
ÁÖs	ÁØ
ÁÖf	(!)	ÁÙ
ÁÙr	ÁÚ
ÁÙa	ÁÛ
ÁÖa	ÁÜ
ÁÖq	ÁÝ
ÁÖt	ÁÞ
ÁÖd	Áß
ÁÖj	(!)	Áà
ÁàT	Áá
ÁÖp	Áâ
ÁÖl	(!)	Áã
Áãr	Áä
Áãs	Áå
Áãf	Áæ
Áãa	Áç
Áãq	Áè
Áãt	Áé

¤¸b	(!)	Áê
Áês	Áë
Áêf	Áì
Áêa	Áí

¤¸m	(!)	Áî
Áîr	Áï
Áîs	Áð
Áîf     Áñ
Áîa	Áò
Áîq	Áó
Áît	Áô
Áîd	Áõ

¤¸l	(!)	Áö
Áör	Á÷
Áös	Áø
Áöe	Áù
Áöf	(!)	Áú
Áúa	Áû
Áöa	Áü
Áöq	Áý
Áöt	Áþ
Áöd	Â¡
Áöw	Â¢
Áöx	Â£
Áöv	Â¤


;; 34.5 W ¤¹
¤¹k	(!)	Â¥
Â¥r	Â¦
Â¥s	(!)	Â§
Â§g	Â¨
Â¥f	(!)	Â©
Â©q	Âª
Â¥a	Â«
Â¥q	Â¬
Â¥t	Â­
Â¥T	Â®
Â¥d	Â¯

¤¹o	(!)	Â°
Â°r	Â±
Â°s	Â²
Â°f	Â³
Â°a	Â´
Â°q	Âµ
Â°t	Â¶
Â°T	Â·
Â°d	Â¸

¤¹i	(!)	Â¹
Â¹s	Âº
Â¹d	Â»

¤¹j	(!)	Â¼
Â¼r	Â½
Â¼s	Â¾
Â¼f	Â¿
Â¼a	ÂÀ
Â¼q	ÂÁ
Â¼t	ÂÂ
Â¼T	ÂÃ
Â¼d	ÂÄ

¤¹p	(!)	ÂÅ
ÂÅd	ÂÆ

¤¹u	(!)	ÂÇ
ÂÇT	ÂÈ

¤¹h	(!)	ÂÉ
ÂÉr	ÂÊ
ÂÉs	ÂË
ÂÉf	ÂÌ
ÂÉa	ÂÍ
ÂÉq	ÂÎ
ÂÉt	ÂÏ
ÂÉd	ÂÐ
ÂÉc	ÂÑ
ÂÉk	(!)	ÂÒ
ÂÒr	ÂÓ
ÂÒf	ÂÔ
ÂÒT	ÂÕ
ÂÉo	(!)	ÂÖ
ÂÖT	Â×
ÂÉl	(!)	ÂØ
ÂØs	ÂÙ
ÂØf	ÂÚ
ÂØa	ÂÛ
ÂØq	ÂÜ

¤¹yd	ÂÝ

¤¹n	(!)	ÂÞ
ÂÞr	Âß
ÂÞs	Âà
ÂÞf	Âá
ÂÞa	Ââ
ÂÞq	Âã
ÂÞd     Âä
ÂÞj     (!)	Âå
ÂåT	Âæ
Âåd	Âç
ÂÞl	Âè

¤¹b	Âé

¤¹m	(!)	Âê
Âêa	Âë
Âêt	Âì
Âêd	Âí

¤¹l	(!)	Âî
Âîr	Âï
Âîs	Âð
Âîf	Âñ
Âîa	Âò
Âîq	Âó
Âîd	Âô
Âîw	Âõ
Âîg	Âö


;; 34.87 c ¤º
¤ºk	(!)	Â÷
Â÷r	Âø
Â÷s	(!)	Âù
Âùg	Âú
Â÷f	Âû
Â÷a	Âü
Â÷q	Âý
Â÷t	Âþ
Â÷T     Ã¡
Â÷d	Ã¢
Â÷w	Ã£

¤ºo	(!)	Ã¤
Ã¤r	Ã¥
Ã¤s	Ã¦
Ã¤f	Ã§
Ã¤a	Ã¨
Ã¤q	Ã©
Ã¤t	Ãª
Ã¤T	Ã«
Ã¤d	Ã¬
¤ºi	(!)	Ã­
Ã­s	(!)	Ã®
Ã®g	Ã¯
Ã­f	Ã°
Ã­a	Ã±
Ã­d	Ã²

¤ºj	(!)	Ã³
Ã³r	Ã´
Ã³s	Ãµ
Ã³f	Ã¶
Ã³a	Ã·
Ã³q	Ã¸
Ã³t	Ã¹
Ã³T	Ãº
Ã³d	Ã»

¤ºp	(!)	Ã¼
Ã¼r	Ã½
Ã¼s	Ã¾
Ã¼f	Ã¿
Ã¼a	ÃÀ
Ã¼q	ÃÁ
Ã¼t	ÃÂ
Ã¼d	ÃÃ

¤ºu	(!)	ÃÄ
ÃÄs	ÃÅ
ÃÄT	ÃÆ
ÃÄl     (!)	ÃÇ
ÃÇs	ÃÈ
ÃÇd	ÃÉ

¤ºh	(!)	ÃÊ
ÃÊr	ÃË
ÃÊs	ÃÌ
ÃÊf	ÃÍ
ÃÊa	ÃÎ
ÃÊq	ÃÏ
ÃÊt	ÃÐ
ÃÊd	ÃÑ
ÃÊk	(!)	ÃÒ
ÃÒs	ÃÓ
ÃÒf	ÃÔ
ÃÒd	ÃÕ
ÃÊl	(!)	ÃÖ
ÃÖs	Ã×
ÃÖf	ÃØ
ÃÖa	ÃÙ
ÃÖq	ÃÚ
ÃÖt	ÃÛ
ÃÖd	ÃÜ

¤ºy	(!)	ÃÝ
ÃÝa	ÃÞ

¤ºn	(!)	Ãß
Ãßr	Ãà
Ãßs	Ãá
Ãßf	Ãâ
Ãßa	Ãã
Ãßq	Ãä
Ãßt	Ãå
Ãßd	Ãæ
Ãßj	(!)	Ãç
ÃçT	Ãè
Ãßp	(!)	Ãé
Ãés     Ãê
Ãßl	(!)	Ãë
Ãës	Ãì
Ãëf	Ãí
Ãëa	Ãî
Ãëq    	Ãï
Ãët	Ãð
Ãëd	Ãñ

¤ºb	(!)	Ãò
Ãòs	Ãó
Ãòf	Ãô
Ãòa	Ãõ
Ãòd	Ãö

¤ºm	(!)	Ã÷
Ã÷r	Ãø
Ã÷s	Ãù
Ã÷f	Ãú
Ã÷a	Ãû
Ã÷q     Ãü
Ã÷t	Ãý
Ã÷d	Ãþ

¤ºl	(!)	Ä¡
Ä¡r	Ä¢
Ä¡s	Ä£
Ä¡e	Ä¤
Ä¡f     (!)	Ä¥
Ä¥r	Ä¦
Ä¡a	Ä§
Ä¡q	Ä¨
Ä¡t	Ä©
Ä¡d	Äª


;; 36.11 z ¤»
¤»k	(!)	Ä«
Ä«r	Ä¬
Ä«s	Ä­
Ä«f	Ä®
Ä«a	Ä¯
Ä«q	Ä°
Ä«t	Ä±
Ä«d	Ä²

¤»o	(!)	Ä³
Ä³r	Ä´
Ä³s	Äµ
Ä³f	Ä¶
Ä³a	Ä·
Ä³q	Ä¸
Ä³t	Ä¹
Ä³T	Äº
Ä³d	Ä»

¤»i	(!)	Ä¼
Ä¼r	Ä½
Ä¼d	Ä¾

¤»j	(!)	Ä¿
Ä¿r	ÄÀ
Ä¿s	ÄÁ
Ä¿e	ÄÂ
Ä¿f	ÄÃ
Ä¿a	ÄÄ
Ä¿q	ÄÅ
Ä¿t	ÄÆ
Ä¿T	ÄÇ
Ä¿d	ÄÈ

¤»p	(!)	ÄÉ
ÄÉr	ÄÊ
ÄÉs     ÄË
ÄÉf	ÄÌ
ÄÉa	ÄÍ
ÄÉq	ÄÎ
ÄÉt	ÄÏ
ÄÉd	ÄÐ

¤»u	(!)	ÄÑ
ÄÑs	ÄÒ
ÄÑf	ÄÓ
ÄÑa	ÄÔ
ÄÑq	ÄÕ
ÄÑt	ÄÖ
ÄÑT	Ä×
ÄÑd	ÄØ
ÄÑl	ÄÙ

¤»h	(!)	ÄÚ
ÄÚr	ÄÛ
ÄÚs	ÄÜ
ÄÚf	ÄÝ
ÄÚa	ÄÞ
ÄÚq	Äß
ÄÚt	Äà
ÄÚd	Äá
ÄÚk	(!)	Äâ
Äâr	Äã
Äâs	Ää
Äâf	Äå
Äâa	Äæ
Äâd	Äç
ÄÚo	(!)	Äè
Äèd	Äé
ÄÚl	(!)	Äê
Äêf	Äë

¤»y	Äì

¤»n	(!)	Äí
Äír	Äî
Äíf	Äð
Äía	Äñ
Äíq	Äò
Äít	Äó
Äíd	Äô
Äíj	(!)	Äõ
Äõs	Äö
Äõf	Ä÷
Äõd	Äø
Äíp	(!)	Äù
Äùd	Äú
Äíl	(!)	Äû
Äûr	Äü
Äûs	Äý
Äûf	Äþ
Äûa	Å¡
Äûq	Å¢
Äût	Å£
Äûd	Å¤

¤»b	(!)	Å¥
Å¥s	Å¦
Å¥f	Å§
Å¥a	Å¨

¤»m	(!)	Å©
Å©r	Åª
Å©s	Å«
Å©f	Å¬
Å©a	Å­
Å©q	Å®
Å©d	Å¯

¤»l	(!)	Å°
Å°r	Å±
Å°s	Å²
Å°f	Å³
Å°a	Å´
Å°q	Åµ
Å°t	Å¶
Å°d	Å·


;; 37.24 x ¤¼
¤¼k	(!)	Å¸
Å¸r	Å¹
Å¸s	Åº
Å¸f	(!)	Å»
Å»r	Å¼
Å¸a	Å½
Å¸q	Å¾
Å¸t	Å¿
Å¸T	ÅÀ
Å¸d	ÅÁ

¤¼o	(!)	ÅÂ
ÅÂr	ÅÃ
ÅÂs	ÅÄ
ÅÂf	ÅÅ
ÅÂa	ÅÆ
ÅÂq	ÅÇ
ÅÂt	ÅÈ
ÅÂT	ÅÉ
ÅÂd	ÅÊ

¤¼i	(!)	ÅË
ÅËd	ÅÌ

¤¼j	(!)	ÅÍ
ÅÍr	ÅÎ
ÅÍs	ÅÏ
ÅÍf	(!)	ÅÐ
ÅÐa	ÅÑ
ÅÍa	ÅÒ
ÅÍq	ÅÓ
ÅÍt	ÅÔ
ÅÍT	ÅÕ
ÅÍd	ÅÖ

¤¼p	(!)	Å×
Å×r	ÅØ
Å×s	ÅÙ
Å×f	ÅÚ
Å×a	ÅÛ
Å×q	ÅÜ
Å×t	ÅÝ
Å×d	ÅÞ

¤¼u	(!)	Åß
Åßs	Åà
ÅßT	Åá
Åßl     (!)	Åâ
Åâs	Åã

¤¼h	(!)	Åä
Åär	Åå
Åäs	Åæ
Åäf	Åç
Åäa	Åè
Åäq	Åé
Åät	Åê
Åäd	Åë
Åäv	Åì
Åäk	(!)	Åí
Åís	Åî
Åäo	Åï
Åäl	(!)	Åð
Åðs	Åñ
Åðt     Åò
Åðd	Åó

¤¼y	Åô

¤¼n	(!)	Åõ
Åõr	Åö
Åõs	Å÷
Åõf	Åø
Åõa	Åù
Åõq	Åú
Åõt	Åû
Åõd	Åü
Åõj	(!)	Åý
ÅýT	Åþ
Åõp	Æ¡
Åõl	(!)	Æ¢
Æ¢r	Æ£
Æ¢s	Æ¤
Æ¢f	Æ¥
Æ¢a	Æ¦
Æ¢q	Æ§
Æ¢d	Æ¨

¤¼b	(!)	Æ©
Æ©s	Æª
Æ©f	Æ«
Æ©a	Æ¬
Æ©d	Æ­

¤¼m	(!)	Æ®
Æ®r	Æ¯
Æ®s	Æ°
Æ®e	Æ±
Æ®f	(!)	Æ²
Æ²a	Æ³
Æ®a	Æ´
Æ®q	Æµ
Æ®t	Æ¶
Æ®l	(!)	Æ·
Æ·s	Æ¸
Æ·f	Æ¹
Æ·a	Æº
Æ·q	Æ»

¤¼l	(!)	Æ¼
Æ¼r	Æ½
Æ¼s	Æ¾
Æ¼f	Æ¿
Æ¼a	ÆÀ
Æ¼q	ÆÁ
Æ¼t	ÆÂ
Æ¼d	ÆÃ


;; 38.26 v ¤½
¤½k	(!)	ÆÄ
ÆÄr	ÆÅ
ÆÄR	ÆÆ
ÆÄs	ÆÇ
ÆÄf	(!)	ÆÈ
ÆÈa     ÆÉ
ÆÄa	ÆÊ
ÆÄq	ÆË
ÆÄt	ÆÌ
ÆÄT 	ÆÍ
ÆÄd	ÆÎ
ÆÄx	ÆÏ

¤½o	(!)	ÆÐ
ÆÐr	ÆÑ
ÆÐs	ÆÒ
ÆÐf	ÆÓ
ÆÐa	ÆÔ
ÆÐq     ÆÕ
ÆÐt	ÆÖ
ÆÐT	Æ×
ÆÐd	ÆØ

¤½i	(!)	ÆÙ
ÆÙr	ÆÚ

¤½j     (!)	ÆÛ
ÆÛr     ÆÜ
ÆÛs	ÆÝ
ÆÛa     Æß
ÆÛq	Æà
ÆÛt	Æá
ÆÛT	Æâ
ÆÛd	Æã

¤½p	(!)	Æä
Æär	Æå
Æäs	Ææ
Æäf	Æç
Æäa	Æè
Æäq	Æé
Æät	Æê
Æäd	Æë

¤½u	(!)	Æì
Æìs	Æí
Æìf	Æî
Æìa	Æï
Æìq	Æð
ÆìT	Æñ
Æìd	Æò
Æìl	(!)	Æó
Æóf	Æô
Æóq	Æõ
Æót	Æö

¤½h	(!)	Æ÷
Æ÷r	Æø
Æ÷s	Æù
Æ÷f	Æú
Æ÷a	Æû
Æ÷q	Æü
Æ÷t	Æý
Æ÷d	Æþ
Æ÷k	(!)	Ç¡
Ç¡d	Ç¢
Æ÷l	(!)	Ç£
Ç£s	Ç¤

¤½y	(!)	Ç¥
Ç¥s	Ç¦
Ç¥f	Ç§
Ç¥q	Ç¨
Ç¥t	Ç©

¤½n	(!)	Çª
Çªr	Ç«
Çªs	Ç¬
Çªe	Ç­
Çªf	(!)	Ç®
Ç®a	Ç¯
Çªa	Ç°
Çªq	Ç±
Çªt	Ç²
Çªd	Ç³
Çªj	(!)	Ç´
Ç´d	Çµ
Çªl	(!)	Ç¶
Ç¶s	Ç·
Ç¶f	Ç¸
Ç¶a	Ç¹
Ç¶t	Çº

¤½b	(!)	Ç»
Ç»s	Ç¼
Ç»f	Ç½
Ç»a	Ç¾
Ç»t	Ç¿
Ç»d	ÇÀ

¤½m	(!)	ÇÁ
ÇÁs	ÇÂ
ÇÁf	ÇÃ
ÇÁa	ÇÄ
ÇÁq     ÇÅ
ÇÁt     ÇÆ

¤½l	(!)	ÇÇ
ÇÇr	ÇÈ
ÇÇs	ÇÉ
ÇÇf	ÇÊ
ÇÇa	ÇË
ÇÇq	ÇÌ
ÇÇt	ÇÍ
ÇÇd	ÇÎ


;; 39.47 g ¤¾
¤¾k	(!)	ÇÏ
ÇÏr	ÇÐ
ÇÏs	ÇÑ
ÇÏf	(!)	ÇÒ
ÇÒx	ÇÓ
ÇÏa     ÇÔ
ÇÏq	ÇÕ
ÇÏt	ÇÖ
ÇÏd	Ç×

¤¾o	(!)	ÇØ
ÇØr	ÇÙ
ÇØs	ÇÚ
ÇØf	ÇÛ
ÇØa	ÇÜ
ÇØq	ÇÝ
ÇØt	ÇÞ
ÇØT	Çß
ÇØd	Çà

¤¾i	(!)	Çá
Çád	Çâ

¤¾j	(!)	Çã
Çãr	Çä
Çãs	Çå
Çãf	(!)	Çæ
Çæa	Çç
Çãa	Çè
Çãq	Çé
Çãt	Çê
Çãd	Çë

¤¾p	(!)	Çì
Çìr	Çí
Çìs	Çî
Çìf	Çï
Çìa	Çð
Çìq	Çñ
Çìt	Çò
Çìd	Çó

¤¾u	(!)	Çô
Çôr	Çõ
Çôs	Çö
Çôf	Ç÷
Çôa	Çø
Çôq	Çù
Çôt	Çú
ÇôT     Çû
Çôd	Çü
Çôl	(!)	Çý
Çýs	Çþ
Çýf	È¡
Çýq	È¢

¤¾h	(!)	È£
È£r	È¤
È£s	È¥
È£f	(!)	È¦
È¦x	È§
È£a	È¨
È£q	È©
È£t	Èª
È£d	È«
È£x	È¬
È£k	(!)	È­
È­r	È®
È­s	È¯
È­f	È°
È­t	È±
È­d	È²
È£o	(!)	È³
È³r	È´
È³s	Èµ
È³t	È¶
È³d	È·
È£l	(!)	È¸
È¸r	È¹
È¸s	Èº
È¸f	È»
È¸q	È¼
È¸t	È½
È¸d	È¾

¤¾y	(!)	È¿
È¿s	ÈÀ
È¿f	ÈÁ
È¿q	ÈÂ
È¿t	ÈÃ

¤¾n	(!)	ÈÄ
ÈÄr	ÈÅ
ÈÄs	ÈÆ
ÈÄf	(!)	ÈÇ
ÈÇx	ÈÈ
ÈÄa	ÈÉ
ÈÄt	ÈÊ
ÈÄd	ÈË
ÈÄj	(!)	ÈÌ
ÈÌs	ÈÍ
ÈÌf	ÈÎ
ÈÌa	ÈÏ
ÈÌd	ÈÐ
ÈÄp	(!)	ÈÑ
ÈÑr	ÈÒ
ÈÑs	ÈÓ
ÈÑf	ÈÔ
ÈÑd	ÈÕ
ÈÄl	(!)	ÈÖ
ÈÖr	È×
ÈÖs	ÈØ
ÈÖf	ÈÙ
ÈÖa	ÈÚ
ÈÖq	ÈÛ
ÈÖt	ÈÜ
ÈÖd	ÈÝ

¤¾b	(!)	ÈÞ
ÈÞr	Èß
ÈÞs	Èà
ÈÞf	Èá
ÈÞa	Èâ
ÈÞt	Èã
ÈÞd	Èä

¤¾m	(!)	Èå
Èår	Èæ
Èås	(!)	Èç
Èçg	Èè
Èåe	Èé
Èåf	(!)	Èê
Èêr	Èë
Èåa	Èì
Èåq	Èí
Èåt	Èî
Èåd	Èï
Èåx	Èð
Èål	(!)	Èñ
Èñs	Èò
Èñf	Èó
Èña	Èô
Èñq	Èõ
Èñd	Èö

¤¾l	(!)	È÷
È÷r	Èø
È÷s	Èù
È÷f	Èú
È÷a	Èû
È÷q	Èü
È÷t     Èý
È÷d	Èþ

(defvar	conf (list ' '))
(defvar han (between °¡ Èþ))
(han)(conf)	(han)

;(defvar alpha (between A Z))
;(alpha)	(error)
